DESIGNATION_NAME	DESIGNATION_DESCRIPTION	DESIGNATION_LEVEL	LAST_MODIFIED_ON
Manager MIS	Manager MIS	0	NULL
Cluster Credit Manager	Cluster Credit Manager	0	NULL
Credit Admin Executive - CV	Credit Admin Executive - CV	NULL	2014-09-29 15:02:01.977
Segment Head - Secured Business	Segment Head - Secured Business	0	NULL
Manager, Balance Sheet Operations	Manager, Balance Sheet Operations	0	NULL
Vice President - Credit Re-Engineering	Vice President - Credit Re-Engineering	0	NULL
Executive, Finance	Executive, Finance	0	NULL
Manager, Analytics	Manager, Analytics	0	NULL
Management Trainee - Premises Infra & Procurement	Management Trainee - Premises Infra & Procurement	0	NULL
Credit Administration Manager	Credit Administration Manager	0	NULL
Sales Manager - Self Employed PL	Sales Manager - Self Employed PL	0	NULL
Manager - Fraud Risk Management	Manager - Fraud Risk Management	0	NULL
AVP, Technology	AVP, Technology	0	NULL
Product Manager - Two Wheeler	Product Manager - Two Wheeler	0	NULL
Agency Manager - Recovery & City Exit	CEO & President	0	NULL
General Manager – Business HC & Employee Relations	General Manager – Business HC & Employee Relations	0	NULL
Senior Manager Training	Senior Manager Training	0	NULL
Assistant Manager - FCU	Vice President Human Capital	0	NULL
Cluster In Charge	Cluster In Charge	0	NULL
State Insurance Manager	State Insurance Manager	0	NULL
National Sales Manager - Mortgages	National Sales Manager - Mortgages	0	NULL
Recovery Manager	Recovery Manager	0	NULL
ABF Relationship Officer	ABF relationship Officer	0	NULL
Manager, Marketing	Manager, Marketing	0	NULL
Risk Control and Review - Executive	Risk Control and Review - Executive	0	NULL
Senior Vice President Human Capital	Senior Vice President Human Capital	0	NULL
VP, Zonal Sales Manager CV &  Mortgage East	VP, Zonal Sales Manager CV &  Mortgage East	0	NULL
Location Manager - DST	Location Manager - DST	0	NULL
Assistant Manager, HC	Assistant Manager, HC	0	NULL
VP - Operations, South & North	VP - Operations, South & North	0	NULL
Regional Business Manager, SME North & West	Regional Business Manager, SME North & West	0	NULL
GM, Treasury	GM, Treasury	0	NULL
SVP & National Credit Manager - MSME	SVP & National Credit Manager - MSME	0	NULL
Business Capability Building Manager	Business Capability Building Manager	0	NULL
Assistant Manager, Department Support	Assistant Manager, Department Support	0	NULL
Senior Manager, Fraud Risk Management	Senior Manager, Fraud Risk Management	0	NULL
VP - Rural Risk	VP - Rural Risk	0	NULL
Regional Risk Manager - MSME, West	Regional Risk Manager - MSME, West	0	NULL
Branch Incharge - ABF	Branch Incharge - ABF	0	NULL
Assistant Manager - Payment Processing	Assistant Manager - Payment Processing	0	NULL
Management Trainee - Premises Infrastructure Pro	Management Trainee - Premises Infrastructure Pro	0	NULL
Manager, Customer Fulfillment	Manager, Customer Fulfillment	0	NULL
Assistant Unit Mgr Incharge	Assistant Unit Mgr Incharge	0	NULL
SVP, Rural Risk	SVP, Rural Risk	0	NULL
Risk Control and Review - Officer	Risk Control and Review - Officer	0	NULL
Credit Admin Manager - Mortgage	Credit Admin Manager - Mortgage	0	NULL
Sr. Vice President - BP & A	Sr. Vice President - BP & A	0	NULL
Individual RO	Individual RO	0	NULL
EVP, Chief Operating Officer	EVP, Chief Operating Officer	0	NULL
VP - Rural	VP Rural	0	NULL
Management Trainee - Technology	Management Trainee - Technology	0	NULL
Credit Approver	Credit Approver	0	NULL
Senior Manager, Treasury	Senior Manager, Treasury	0	NULL
AVP - Premises Procurement and Infrastructure	AVP - Premises Procurement & Infrastructure	0	NULL
VP - Quality, Process and Control	VP - Quality, Process and Control	0	NULL
Credit Manager - Mortgage	Credit Manager - Mortgage	0	NULL
Relationship Manager - CV	Relationship Manager - CV	0	NULL
Agency Officer - Flows & Recovery	Credit Manager	0	NULL
Unit Manager	Unit Manager	0	NULL
AVP - Legal and Compliance	AVP - Legal and Compliance	0	NULL
GM - National Collections Manager	GM - National Collections Manager	0	NULL
Credit Approver, SME	Credit Approver, SME	0	NULL
VP - Risk Control and Review	VP - Risk Control and Review	0	NULL
AVP - Training	AVP - Training	0	NULL
Unit Incharge	Unit Incharge for Microfinance	0	NULL
Segment Risk Manager - Secured	Segment Risk Manager - Secured	0	NULL
Assistant Manager Training	Assistant Manager Training	0	NULL
Senior Manager Payroll	Senior Manager Payroll	0	NULL
Assistant Vice President, CV	Assistant Vice President, CV	0	NULL
Credit Manager - CV	Credit Manager - CV	0	NULL
AVP - Quality, Process and Control	AVP - Quality, Process and Control	0	NULL
Regional Collections Manager - South	Regional Collections Manager - South	0	NULL
Management Trainee - Rural	Management Trainee - Rural	0	NULL
Product Manager - Business Loans & Fee Business	Product Manager - Business Loans & Fee Business	0	NULL
Senior Manager - Collections	Senior Manager - Collections	0	NULL
VP - Operations, West & East	VP - Operations, West & East	0	NULL
Officer	Officer	0	NULL
Cluster Collections Manager - Flows  Recovery	Cluster Collections Manager - Flows & Recovery	0	NULL
Manager, Operations	Manager, Operations	0	NULL
AVP - Technology - Applications	AVP - Technology - Applications	0	NULL
Credit Admin Officer - Mortgage	Credit Admin Officer - Mortgage	0	NULL
GM, Chief Information Officer	GM, Chief Information Officer	0	NULL
Product Manager - MSD	Product Manager - MSD	0	NULL
SVP - Regional Business Manager, West	SVP - Regional Business Manager, West	0	NULL
Associate Credit Officer	Associate credit officer	0	NULL
Collection Officer - Mortgage	Collection Officer - Mortgage	0	NULL
Manager, Premises Infrastructure and Procurement	Manager, Premises Infrastructure and Procurement	0	NULL
MIS Executive	MIS Executive	0	NULL
AVP - IT Business Solutions	AVP - IT Business Solutions	0	NULL
AVP, Branch Distribution, Retail	AVP, Branch Distribution, Retail	0	NULL
EVP, Sales & Product Head  - Urban Business	EVP, Sales & Product Head  - Urban Business	0	NULL
Executive - Process & Control	Executive - Process & Control	0	NULL
AVP - Internal Audit	AVP - Internal Audit	0	NULL
Senior Manager, Technology	Senior Manager, Technology	0	NULL
Relationship Executive - CV	Relationship Executive - CV	0	NULL
VP - Treasury	VP - Treasury	0	NULL
AVP - Central Marketing	AVP - Central Marketing	0	NULL
Regional Risk Manager - Retail, South	Regional Risk Manager - Retail, South	0	NULL
Relationship Executive - Mortgage	Relationship Executive - Mortgage	0	NULL
Cluster Collections Manager - Flows	Cluster Collections Manager - Flows	0	NULL
VP - State Business Manager	VP - State Business Manager	0	NULL
Senior Risk Officer	Senior Risk Officer	0	NULL
AVP - Collection Systems	AVP - Collection Systems	0	NULL
Senior Manager, Premises Infrastructure and Procu	Senior Manager, Premises Infrastructure and Procurement	0	NULL
Area Credit Manager	Officer	0	NULL
Manager Human Capital	Manager Human Capital	0	NULL
State Credit Manager - BIL	State Credit Manager - BIL	0	NULL
Vice President - Marketing & CSR	Vice President - Marketing & CSR	0	NULL
Agency Manager - Flows & Recovery	AVP - Risk Control and Review	0	NULL
Assistant Manager MIS	Assistant Manager MIS	0	NULL
Collections Officer - MSD	Collections Officer - MSD	0	NULL
Sr. VP - Technology Infrastructure	Sr. VP - Technology Infrastructure	0	NULL
Senior IRO	Senior IRO for Microfinance	0	NULL
Sales Manager	Sales Manager	0	NULL
Senior Manager Outbound Sales	Senior Manager Outbound Sales	0	NULL
Assistant Manager - Retail Credit	Assistant Manager - Retail Credit	0	NULL
Assistant Manager, Technology	Assistant Manager, Technology	0	NULL
Assistant Manager - Mortgages	VP - Risk Strategy	0	NULL
Assistant Manager, Operations	Assistant Manager, Operations	0	NULL
General Manager, Learning and Development	General Manager, Learning and Development	0	NULL
SVP - Regional Business Manager, North	SVP - Regional Business Manager, North	0	NULL
Assistant Vice President - Analytics (Unsecured)	Assistant Vice President - Analytics (Unsecured)	0	NULL
Assessment Officer	Senior Manager -  Credit Process	0	NULL
National Sales Manager - CV Business & RBH East	National Sales Manager - CV Business & RBH East	0	NULL
Senior Manager Human Capital	Senior Manager, Human Capital	0	NULL
VP - Internal Audit	VP - Internal Audit	0	NULL
VP - Systems Operations	VP - Systems Operations	0	NULL
Executive - Analytics & Information Management	Executive - Analytics & Information Management	0	NULL
Business Process Manager	Business Process Manager	0	NULL
State Business Manager	State Business Manager	0	NULL
Credit Officer	Credit Officer	0	NULL
SVP - Risk Control and Review	SVP - Risk Control and Review	0	NULL
Executive - Department Support	Department Support	0	NULL
Regional Risk Manager - Retail North & West	Regional Risk Manager - Retail North & West	0	NULL
Zonal Manager - Mortgages, North	Zonal Manager - Mortgages, North	0	NULL
Assistant Manager - Retail	Assistant Manager - Retail	0	NULL
Head - Finance and Company Secretary	Head - Finance and Company Secretary	0	NULL
Senior Manager, Business Planning	Senior Manager, Business Planning	0	NULL
Agency Incharge - Recovery & City Exit	AVP - Credit Process	0	NULL
Vendor - Collections	Vendor - Collections	0	NULL
Vice President Human Capital	Vice President Human Capital	0	NULL
State Credit Manager - Mortgage	State Credit Manager - Mortgage	0	NULL
Senior Manager - Collections Strategy	Senior Manager - Collections Strategy	0	NULL
Vendor	Vendor	0	NULL
Executive, Legal and Compliance	Executive, Legal and Compliance	0	NULL
Branch Collections Incharge	Branch Collections Incharge	0	NULL
SVP - Regional Business Manager, West 1	SVP - Regional Business Manager, West 1	0	NULL
EVP, Chief Risk Officer	EVP, Chief Risk Officer	0	NULL
Assistant Manager - PIP	Assistant Manager - PIP	0	NULL
VP - Risk Strategy	VP - Risk Strategy	0	NULL
Regional Risk Manager	Regional Risk Manager	0	NULL
ABF Relationship Executive	ABF Relationship Executive	0	NULL
EVP, Head of Business & Marketing	EVP, Head of Business & Marketing	0	NULL
Manager Training	Manager Training	0	NULL
Assistant Vice President - Operations	Assistant Vice President - Operations	0	NULL
Senior Manager, Accounts and Taxation	Senior Manager, Accounts and Taxation	0	NULL
Operations Manager	Operations Manager	0	NULL
Manager, Accounts and Taxation	Manager, Accounts and Taxation	0	NULL
Collection Officer - ABF	Collection Officer - ABF	0	NULL
Credit Admin Executive - Mortgage	Credit Admin Executive - Mortgage	0	NULL
Regional Collection Manager - West & East	Regional Collection Manager - West & East	0	NULL
Area Manager	Premises and Infrastucture Manager	0	NULL
Product Risk Head - Secured	Product Risk Head - Secured	0	NULL
Tele-Calling Officer	Tele-Calling Officer	0	NULL
Customer Segment Manager - Personal Loans	Customer Segment Manager - Personal Loans	0	NULL
Sr Group Credit Officer	Sr Group Credit Officer for Microfinance	0	NULL
Senior Manager - Corporate Planning and Projects	Senior Manager - Corporate Planning and Projects	0	NULL
Assistant Manager, Accounts and Taxation	Assistant Manager, Accounts and Taxation	0	NULL
SVP - Rural, North & West	SVP - Rural, North & West	0	NULL
Management Trainee - Analytics & Information Mgmt	Management Trainee - Analytics & Information Mgmt	0	NULL
Regional Business Manager, Mortgage & SME South	Regional Business Manager, Mortgage & SME South	0	NULL
Manager, Finance	Manager, Finance	0	NULL
Assistant Unit Manager	Assistant Unit Manager	0	NULL
GM - Credit Policy & Underwriting - Urban	GM - Credit Policy & Underwriting - Urban	0	NULL
Relationship Manager	Relationship Manager	0	NULL
Assistant Manager - Procurement	Assistant Manager - Procurement	0	NULL
Manager - Payment Processing	Manager - Payment Processing	0	NULL
AVP, Zonal Sales Manager CV	AVP, Zonal Sales Manager CV	0	NULL
SVP - Commercial Vehicle Credit & Collection	SVP - Commercial Vehicle Credit & Collection	0	NULL
Product Risk Head - Unsecured	Product Risk Head - Unsecured	0	NULL
Branch Processing Officer	Branch Processing Officer	0	NULL
Assistant Manager - Commercial	Sr. VP – Finance & Company Secretary	0	NULL
SSU Manager	SSU Manager	0	NULL
Vice President, Head - Customer Service	Vice President, Head - Customer Service	0	NULL
Sr. VP - IT Business Solutions	Sr. VP - IT Business Solutions	0	NULL
Manager Comp & Ben	Manager Comp & Ben	0	NULL
Area Credit Manager - CV	Officer Trainee	0	NULL
Assistant Manager, Legal and Compliance	Assistant Manager, Legal and Compliance	0	NULL
Assistant Manager, Customer Fulfillment	Assistant Manager, Customer Fulfillment	0	NULL
Information Security Officer	Information Security Officer	0	NULL
Sr Unit Manager	Sr Unit Manager for Microfinance	0	NULL
Regional Risk Manager - MSME, South & East	Regional Risk Manager - MSME, South & East	0	NULL
Transaction Officer	Transaction Officer	0	NULL
Regional Collections Manager - North	Regional Collections Manager - North	0	NULL
State Credit Manager	State Credit Manager	0	NULL
Sales Manager - DST	Sales Manager - DST	0	NULL
Assistant Manager, Finance	Assistant Manager, Finance	0	NULL
AVP Comp & Ben	AVP Comp & Ben	0	NULL
Manager - Process Support	Manager - Process Support	0	NULL
Executive Human Capital	Executive Human Capital	0	NULL
AVP - Corporate Sustainability and Responsibility	AVP - Corporate Sustainability and Responsibility	0	NULL
VP, Legal and Compliance	VP, Legal and Compliance	0	NULL
Senior Manager, Premises Infra and Procur	Senior Manager, Premises Infrastructure and Procurement	0	2014-09-29 16:01:19.270
ABF Relationship Manager	ABF Relationship Manager	0	NULL
VP - Operational Risk	VP - Operational Risk	0	NULL
Customer Segment Risk Manager (Unsecured)	Customer Segment Risk Manager (Unsecured)	0	NULL
Senior Manager, Marketing	Senior Manager, Marketing	0	NULL
EVP, Head of Business, Marketing & CSR	EVP, Head of Business, Marketing & CSR	0	NULL
SVP - IT Business Solutions	SVP - IT Business Solutions	0	NULL
System Administrator	System Administrator	0	NULL
Credit Admin Officer - CV	Credit Admin Officer - CV	0	NULL
Credit Admin	Credit Admin	0	NULL
Sales Manager - PL	Sales Manager - PL	0	NULL
Collections Quality & Controls	Collections Quality & Controls	0	NULL
Cluster Risk Incharge	Cluster Risk Incharge	0	NULL
Agency Manager - Flows	AVP - Fee Product	0	NULL
State Credit Manager – BIL & MSME	State Credit Manager – BIL & MSME	0	NULL
Cluster Collections Manager	Cluster Collections Manager	0	NULL
SSU Officer	SSU Officer	0	NULL
Area Credit Manager - Mortgage	Area Credit Manager - Mortgage	0	NULL
Sr. Manager, Business Intelligence Unit	Sr. Manager, Business Intelligence Unit	0	NULL
IRO - Commercial Vehicle	IRO - Commercial Vehicle	0	NULL
Manager - Legal	Manager - Legal	0	NULL
AVP - Operations	AVP - Operations	0	NULL
Cluster Collections Manager - Recovery	Cluster Collections Manager - Recovery	0	NULL
Product Manager - Commercial Vehicle	Product Manager - Commercial Vehicle	0	NULL
Regional Collection Manager, ABF North	Regional Collection Manager, ABF North	0	NULL
Location Manager - EB	Location Manager - EB	0	NULL
VP - Payroll & Compliance	VP - Payroll & Compliance	0	NULL
Associate TO	Associate TO	0	NULL
Chief Executive Officer and Managing Director	Chief Executive Officer and Managing Director	0	NULL
Collections Manager - ABF	Collections Manager - ABF	0	NULL
Credit Manager - BIL	Credit Manager - BIL	NULL	2014-12-30 19:37:06.007
State Risk Manager	State Risk Manager	0	NULL
Relationship Officer - Mortgage	Relationship Officer - Mortgage	0	NULL
Senior Manager, Finance	Senior Manager, Finance	0	NULL
Officer Trainee	Officer Trainee	0	NULL
GM, Sales & Product Head - Rural Business	GM, Sales & Product Head - Rural Business	0	NULL
GM - Analytics & Information Management	GM - Analytics & Information Management	0	NULL
Customer Service Officer	Customer Service Officer	0	NULL
Group Credit Officer	Group Credit Officer	0	NULL
Regional Manager - Fraud Risk - South	Fraud Risk - Regional Manager - South	0	NULL
Executive Assistant	Executive Assistant	0	NULL
VP, Premises Procurement and Infrastructure	VP, Premises Procurement and Infrastructure	0	NULL
Assistant Manager	Senior Manager - PL Product	0	NULL
National Manager - Branch Sales	National Manager - Branch Sales	0	NULL
Regional Manager - Fraud Risk - West & East	Fraud Risk - Regional Manager - West & East	0	NULL
Senior Manager, Insurance	Senior Manager, Insurance	0	NULL
Assistant Manager - Collection Strategy	Senior Officer	0	NULL
Manager, Risk and Control Review	Manager, Risk and Control Review	0	NULL
Manager - Procurement	Manager - Procurement	0	NULL
Risk Manager	Risk Manager	0	NULL
Senior Manager - IT Business Solutions	Senior Manager - IT Business Solutions	0	NULL
Assistant Manager - Infosec	Assistant Manager - Infosec	0	NULL
Vendor - Recovery	Vendor - Recovery	0	NULL
Business Unit Manager	Business Unit Manager	0	NULL
Senior Manager, Internal Audit	Senior Manager, Internal Audit	0	NULL
Manager, SME Business and Institutional Inv	Manager, SME Business and Institutional Inv	0	NULL
Senior Team Leader	Senior Team Leader	0	NULL
SVP - Administration and Fraud Risk	SVP - Administration and Fraud Risk	0	NULL
State Collections Manager	State Collections Manager	0	NULL
Hub Credit Manager	Hub Credit Manager	0	NULL
Branch Incharge	Branch Incharge	0	NULL
Manager, Rural	Manager, Rural	0	NULL
State Collections Manager - Recovery	State Collections Manager - Recovery	0	NULL
Relationship Manager - Mortgage	Relationship Manager - Mortgage	0	NULL
Risk Control and Review - Manager	Risk Control and Review - Manager	0	NULL
AVP - Risk Control and Review	AVP - Risk Control and Review	0	NULL
Team Leader	Team Leader	0	NULL
EVP, Chief Financial Officer	EVP, Chief Financial Officer	0	NULL
Sales Manager - Salaried PL	Sales Manager - Salaried PL	0	NULL
Regional Manager - Fraud Risk - North	Fraud Risk - Regional Manager - North	0	NULL
Assistant Manager - Corporate Planning & Projects	State Risk Manager	0	NULL
VP, Zonal Sales Manager CV	VP, Zonal Sales Manager CV	0	NULL
Senior Manager Collections	Senior Manager Collections	0	NULL
Collections Officer	Collections Officer	0	NULL
SVP Legal & Regional Risk Manager - Retail East	SVP Legal & Regional Risk Manager - Retail East	0	NULL
AVP - Human Capital	AVP - Human Capital	0	NULL
Associate RO	Associate RO	0	NULL
VP - Risk Analytics	VP - Risk Analytics	0	NULL
Assistant Manager, Insurance	Assistant Manager, Insurance	0	NULL
Sr Transaction Officer	Sr Transaction Officer for Microfinance	0	NULL
Management Trainee - Collection Strategy	Management Trainee - Collection Strategy	0	NULL
Relationship Officer - CV	Relationship Officer - CV	0	NULL
State Collections Manager - Flows	State Collections Manager - Flows	0	NULL
Cluster Manager	Cluster Manager	0	NULL
Agency Officer - Recovery	Director, Rural	0	NULL
Credit Executive	Credit Executive	0	NULL
Manager Payroll	Manager Payroll	0	NULL
Executive	Executive	0	NULL
Executive - Fraud Risk	Fraud Risk - Executive	0	NULL
Credit Administration Officer - Mortgage	Credit Administration Officer - Mortgage	0	NULL
Customer Segment Manager - Mortgage	Customer Segment Manager - Mortgage	0	NULL
Territory Risk Manager	Territory Risk Manager Mf	0	NULL
VP - Segment Risk (Unsecured)	VP - Segment Risk (Unsecured)	0	NULL
AVP - PIP Regional Manager, North	AVP - PIP Regional Manager, North	0	NULL
Sales Manager - EB	Sales Manager - EB	0	NULL
Agency Manager - Recovery	Business Development Manager - Rural	0	NULL
Assistant Vice President, Finance	Assistant Vice President, Finance	0	NULL
SVP & National Credit Manager - Retail Unsecured	SVP & National Credit Manager - Retail Unsecured	0	NULL
Management Trainee	Management Trainee	0	NULL
Segment Head - Unsecured Business	Segment Head - Unsecured Business	0	NULL
Senior Officer, FCU	Senior Officer, FCU	0	NULL
AVP, Technology Applications	AVP, Technology Applications	0	NULL
VP - Accounts and Taxation	VP - Accounts and Taxation	0	NULL
Assistant Manager - Business Intelligence Unit	Senior Manager, Organizational Excellence	0	NULL
Regional Collection Manager, ABF South	Regional Collection Manager, ABF South	0	NULL
Senior Officer	Senior Officer	0	NULL
AVP, Expense Processing	AVP, Expense Processing	0	NULL
Executive, Expense Processing	Executive, Expense Processing	0	NULL
Assistant Manager, Comp & Ben	Assistant Manager, Compe & Ben	0	NULL
Cluster Risk Manager	Cluster Risk Manager	0	NULL
Vice President - SME Underwriting	Vice President - SME Underwriting	0	NULL
Sr Individual RO - Mortgage	Sr Individual RO - Mortgage	0	NULL
Assistant Vice President - Technology	Assistant Vice President - Technology	0	NULL
Assistant Vice President - Analytics (Secured)	Assistant Vice President - Analytics (Secured)	0	NULL
AVP - Corporate Planning and Projects	AVP - Corporate Planning and Projects	0	NULL
Agency Officer - Flows	Collections Manager	0	NULL
Executive, Customer Fulfillment	Executive, Customer Fulfillment	0	NULL
AVP, Finance	AVP, Finance	0	NULL
Management Trainee Human Capital	Management Trainee Human Capital	0	NULL
Location Manager - Mortgage	Location Manager - Mortgage	0	NULL
IRO - Mortgage	IRO - Mortgage	0	NULL
Manager, Treasury	Manager, Treasury	0	NULL
GM, Operations & Customer Fulfillment	GM, Operations & Customer Fulfillment	0	NULL
Management Trainee - Operations	Management Trainee - Operations	0	NULL
Assistant Manager, Risk Control and Review	Assistant Manager, Risk Control and Review	0	NULL
Senior Officer, Risk Control and Review	Senior Officer, Risk Control and Review	0	NULL
VP - Operations, Rural	VP - Operations, Rural	0	NULL
Summer Trainee	Summer Trainee	0	NULL
Executive, Department Support	Executive, Department Support	0	NULL
VP - Collateral Management	VP - Collateral Management	0	NULL
State Mortgage Approver	State Mortgage Approver	0	NULL
Sales Manager - NB	Sales Manager - NB	0	NULL
Regional Risk Manager, CV	Regional Risk Manager, CV	0	NULL
Branch Collections Incharge - CV	Branch Collections Incharge - CV	0	NULL
Collection Officer - Recovery	Collection Officer - Recovery	0	NULL
Assistant Manager, Expense Processing	Assistant Manager, Expense Processing	0	NULL
Branch Collections Incharge - Flows	Branch Collections Incharge - Flows	0	NULL
Assistant Manager, Operational Risk	Assistant Manager, Operational Risk	0	NULL
Manager, Legal and Compliance	Manager, Legal and Compliance	0	NULL
EVP, Internal Audit	EVP, Internal Audit	0	NULL
Manager - Risk Strategy	Manager - Risk Strategy	0	NULL
Executive, Premises Infrastructure and Procurement	Executive, Premises Infrastructure and Procurement	0	NULL
Assistant Manager, Treasury	Assistant Manager, Treasury	0	NULL
Senior Manager Compliance	Senior Manager Compliance	0	NULL
Credit Admin Officer - BIL	Credit Admin Officer - BIL	NULL	2015-01-06 14:33:26.263
AVP, Analytics	AVP, Analytics	0	NULL
Assistant Risk Manager	Assistant Risk Manager	0	NULL
Credit Admin Manager - CV	Credit Admin Manager - CV	0	NULL
Collection Officer - Flows	Collection Officer - Flows	0	NULL
Senior Manager - Operations	Senior Manager - Operations	0	NULL
Senior Manager, Operations	Senior Manager, Operations	0	NULL
AVP - Procurement	AVP - Procurement	0	NULL
Business Unit Manager- ABF	Business Unit Manager- ABF	0	NULL
Sr. Relationship Manager - CV	Sr. Relationship Manager - CV	0	NULL
Assistant Manager, Rural	Assistant Manager, Rural	0	NULL
AVP - Operational Risk	AVP - Operational Risk	0	NULL
Credit Executive - CV	Credit Executive - CV	0	NULL
Customer Segment, Risk Manager Mortgage	Customer Segment, Risk Manager Mortgage	0	NULL
Assistant Manager Human Capital	Assistant Manager Human Capital	0	NULL
EVP, Head Human Capital	EVP, Head Human Capital	0	NULL
Manager - HC Systems	Manager - HC Systems	0	NULL
Assistant Manager, Analytics & Information Mgmt	Assistant Manager, Analytics & Information Management	0	NULL
Assistant Manager, Premises Infrastructure and Pro	Assistant Manager, Premises Infrastructure and Procurement	0	NULL
Vendor - Dox Officer	Document Officer Vendor Staff	0	NULL
Manager HC	Manager HC	0	NULL
AVP, SME Business and Institutional Inv	AVP, SME Business and Institutional Inv	0	NULL
SVP - Risk & Policy-Mortgage & SME	SVP - Risk & Policy-Mortgage & SME	0	NULL
Customer Segment Manager - SME	Customer Segment Manager - SME	0	NULL
SVP - Commercial Vehicle Credit	SVP - Commercial Vehicle Credit	0	NULL
Senior Manager, SME Business and Institutional Inv	Senior Manager, SME Business and Institutional Investments	0	NULL
Recovery Officer	Recovery Officer	0	NULL
State Manager - Mortgage	State Manager - Mortgage	0	NULL
VP - Premises Infrastructure	VP - Premises Infrastructure	0	NULL
SVP - Regional Business Manager, South	SVP - Regional Business Manager, South	0	NULL
Segment Head - Insurance & Fee Business	Segment Head - Insurance & Fee Business	0	NULL
Vice President - BIL Underwriting	Vice President - BIL Underwriting	NULL	2015-01-06 14:33:48.137
Sr. Credit Manager - CV	Sr. Credit Manager - CV	0	NULL
Credit Manager	Credit Manager	0	NULL
Assistant Vice President - PL Product	Assistant Vice President - PL Product	0	NULL
SVP - Rural, South	SVP - Rural, South	0	NULL